1111111111
1010101010
0000011111
0101010101
0000011110